R 800 600
NO ./textures/north.xpm
SO ./textures/south.xpm
WE ./textures/west.xpm
EA ./textures/east.xpm
S ./textures/pica.xpm
T ./textures/pick_quest.xpm
F 1,100,0
C 100,203,220
        1111111111111111111111111
        1000000000110000000000051
        1011000001110000002000001
        10010000000X0000H00000001
111111111011000001110000000000041
100000000011000001110111111111111
1111D111111111011100000000B01
11110111111111011101111110001
11000000110101011101    10001
1000200T000000001101    10001
10000000000000001101111110001
11000001110101011100000T00N0111
11110111 1110101 101111010001
11111111 1111111 111111111111