R 800 600

NO ./textures/redbrick.xpm
SO ./textures/colorstone.xpm
WE ./textures/mossy.xpm
EA ./textures/purplestone.xpm
S ./textures/barrel.xpm

T ./textures/pick_quest.xpm

F 1,100,0

C 100,203,220

11111111111111111111111111111
13000000001100001T00100000031
100000000011000011D1100000001
10000B00000D002000E000000B001
10000000001100000000000000001
10000000001130000111X11110001
11110111111111011100000010001
11110111111111011101010010001
1100000011010101110000001H001
10002000000000001100000010001
10B00000000000001101010010001
11000000110101011111011110001
1111T111111101011111L111100T1
11111111111111111111111111111
