R 800 600

NO ./textures/redbrick.xpm
SO ./textures/colorstone.xpm
WE ./textures/mossy.xpm
EA ./textures/purplestone.xpm
S ./textures/barrel.xpm

T ./textures/pick_quest.xpm

F 1,100,0

C 100,203,220



111111         111111111
1020011111111111000B0001111
100001000000000100000001001
1000EO0000B0000D0202020D0T1
100001000000000100000001H01
1111111111D11111000B0001111
        100001 1111111111
        100001   1000000T1
 1111111102001   100011110
 1TB0000D0000111111D1
 111X11111000D00000BT1
 1L0001  111111111111
  1111      