
R 1280 800

NO ./textures/eagle.xpm
SO ./textures/colorstone.xpm
WE ./textures/mossy.xpm
EA ./textures/purplestone.xpm
S ./textures/barrel.xpm

F 1,100,0

C 100,203,220

11111111111111111111111111111
10000000001100000000000000001
10110000011100000020000010001
100100000000000000N0000000001
10110000011100000000000000001
10000000001100000111011110001
11110111111111011100000010001
11110111111111011101010010001
11000000110101011100000010001
10002000000000001100000010001
10000000000000001101010010001
11000000110101011111011110001
11110111111101011111011110001
11111111111111111111111111111
