R 1280 720
NO ./textures/eagle.xpm
SO ./textures/colorstone.xpm
WE ./textures/mossy.xpm
EA ./textures/purplestone.xpm
S ./textures/barrel.xpm

F 1,100,0
C 86,69,66

             11111
        1111111111111111
    111110000000000000011111
   11110000001111000000001111
   11110000001111000020001111
   11110000001111000000001111
   111100000011110000W0001111
    111110000000000000011111
        11111111111111111
             111111